R 900 600
NO ./textures/no.xmp
SO ./textures/so.xmp
WE ./textures/we.xmp
EA ./textures/ea.xmp

S ./textures/sprite.xmp
F 220,100,0
C 225,30,0

   1111111
   1000001
   1000001
1111000101
1000000001
1000001111
1000001
100N001
100000111111111111111111
100000000000000000000001
111111111111111100000001
100000000000000100000001
100000000000000100000001
100000000000000111100111
100000000000000100000001
100000000000000100000001
100000000000000100000001
100000000011111100000001
100000000000000000000001
100000000000000000000001
100000000011111111111111
10000000001
10000000001
10000000001
10000000001
11111111111
