R 300 200
NO ./textures/no.xmp
SO ./textures/so.xmp
WE ./textures/we.xmp
EA ./textures/ea.xmp

S ./textures/sprite.xmp
F 220,100,0
C 225,30,0

11111
10001
10001
10N01
11111
