R 300 200
NO ./textures/no.xmp
SO ./textures/so.xmp
WE ./textures/we.xmp
EA ./textures/ea.xmp

S ./textures/sprite.xmp
F 220,100,0
C 225,30,0

1111 11111
1000 00001
1000100001
1000000101
1000001001
1000000001
1000000001
1000000001
1000000001
10N0000001
1111111111
