R 300 200
NO ./textures/no.xmp
SO ./textures/so.xmp
WE ./textures/we.xmp
EA ./textures/ea.xmp

S ./textures/sprite.xmp
F 220,100,0
C 225,30,0

   1111111
   1000001
   1000001
1111000101
1000000001
1000001111
1000001
100N001
1000001111
1000000001
1111111111
