R 600 400
NO ./textures/summer.xpm
SO ./textures/winter.xpm
WE ./textures/autumn.xpm
EA ./textures/spring.xpm

P ./example.cub
S ./textures/sprite.xpm
F 150,150,150
C 50,200,255

   1111111
   1000001
   1000001
1111000101
1000000001
1000201111
1000201
1000N01
100000111111111111111111
100000000000000000000001
111111101111111100000001
100000000000000100000001
100000000000000100000001
111000000000000111100111
 10000000000000100000001
110100010000000100000001
100100000000000100000111
1001000000111111000001
100000000000000000000111
100000000000000000000001
100000000011111111111111
1000000000011
10000000000011
100000000010011
100000000010001
111111111111111
