R 600 400
NO ./textures/summer.xpm
SO ./textures/winter.xpm
WE ./textures/autumn.xpm
EA ./textures/spring.xpm

S ./textures/sprite.xpm
F 150,150,150
C 50,200,255

11111111111111111111
1E000000001020000021
11111111101111101111
10200000020000000001
11110111111101111101
10000100000101111101
10110101110001020001
10100101011111011101
10121101020000011001
10100101011111000011
10110100011111011111
10000111110000020001
11110010020111111101
11111000111100000001
11111101111101111111
11111100020001
11111111111111
