R 900 600
NO ./textures/no.xpm
SO ./textures/so.xpm
WE ./textures/we.xpm
EA ./textures/ea.xpm

S ./textures/sprite.xpm
F 220,100,0
C 112,0,112

   1111111
   1000001
   1000001
1111000101
1000000001
1000001111
1000001
100N001
1000001111
1000000001
1111111111
