R 900 600
NO ./textures/winter.xpm
SO ./textures/summer.xpm
WE ./textures/spring.xpm
EA ./textures/autumn.xpm

S ./textures/spritecan.xpm
F 150,150,150
C 50,200,255

   1111111
   1000001
   1000001
1111000101
1000020001
1000001111
1000001
100N001
100000111111111111111111
100000000000000000000001
111111111111111100000001
100000000000000100000001
100000000000000100000001
100000000000000111100111
100002000000000100000001
100000000000000100000001
100000200000000100000001
100000000011111100000001
100000000000000000000001
100002000000000000000001
100000000011111111111111
10000000001
10000000001
10000000001
10000000001
11111111111
