R 900 600
NO ./textures/no.xpm
SO ./textures/so.xpm
WE ./textures/we.xpm
EA ./textures/ea.xpm

S ./textures/sprite.xpm
F 100,100,100
C 0,30,200

   1111111
   1000001
   1020001
1111000101
1000020001
1002000111
10000001
10000001
100000N11111111111111111
100000000000000000000001
111111111111111100000001
100000000000000100000001
100000000000000100000001
100000000000000111100111
100000000000000100000001
100000000000000100000001
100000000000000100000001
100000000011111100000001
100000000000000000000001
100000000000000000000001
100000000011111111111111
10000000001
10000000001
10000000001
10000000001
11111111111
