R 300 200
NO ./textures/no.xpm
SO ./textures/so.xpm
WE ./textures/we.xpm
EA ./textures/ea.xpm

S ./textures/sprite.xpm
F 100,100,100
C 0,30,100

1111
1001
10N1
1111

something
