R 300 200
NO ./textures/no.xpm
SO ./textures/so.xpm
WE ./textures/we.xpm
EA ./textures/ea.xpm

S ./textures/sprite.xmp
F 100,100,100
C 0,30,100

111
1001
10N1
1111
