R 800 600
NO ./textures/no-brick.xpm
SO ./textures/so-brick.xpm
WE ./textures/we-brick.xpm
EA ./textures/ea-brick.xpm

S ./textures/sprite.xpm
F 100,100,100
C 0,3a0,100

11111
10001
10001
10N01
11111
